{
  "map": [
    [ 1, 1, 1, 1, 4, 4, 1, 1, 1, 1, 1, 1, 9, 9, 1, 1, 1, 1, 1, 1, 1, 4, 4, 1, 1],
    [ 1, 1, 1, 4, 4, 1, 1,16, 1, 1, 1, 1, 1, 9, 1, 1, 1, 1, 1, 1, 1, 1, 4, 1, 1],
    [ 1, 1, 1, 1, 1, 1, 1, 1, 1, 1,11, 1, 1, 1, 1, 1, 1, 1, 9, 9, 1, 1, 1, 1, 1],
    [ 1, 1,13, 1, 1, 1, 1, 1, 1, 1, 1, 1, 1, 1, 1, 1, 1, 1, 1, 9, 1, 1, 1, 1, 1],
    [ 1, 1, 1, 1, 2, 2, 3, 3, 2, 2, 1, 1, 1, 1, 1, 1, 1, 1, 1, 1, 1, 1, 1, 1, 1],
    [ 1, 1, 1, 2, 2, 3, 3, 5, 5, 2, 2, 1, 1, 1, 1, 1, 1, 1, 1, 1, 1, 1, 1, 1, 1],
    [ 1, 1, 1, 2, 3,15, 2, 5, 2,15, 3, 2, 1, 1, 1, 1, 1, 1, 1, 1, 1, 1, 1, 1, 1],
    [ 1, 1, 1, 2, 3, 2, 6, 6, 6, 2, 3, 2, 1, 1, 1, 1, 1, 1, 1, 1, 1, 1, 1, 1, 1],
    [ 1, 1, 1, 2, 3, 2, 6, 8, 6, 2, 3, 2, 1, 1,18, 1, 1, 1, 1, 1, 1, 1, 1, 1, 1],
    [ 1, 1, 1, 2, 3,17, 2, 6, 2,17, 3, 2, 1, 1, 1, 1, 1, 1, 1, 1, 1, 1, 1, 1, 1],
    [ 1, 1, 1, 2, 2, 3, 3, 7, 3, 3, 2, 2, 1, 1, 1, 1, 1, 1, 1, 1, 1, 1, 1, 1, 1],
    [ 1, 1, 1, 1, 2, 2, 3, 3, 3, 2, 2, 1, 1, 1, 1, 1, 1, 1, 1, 1, 1, 1, 1, 1, 1],
    [ 1, 1, 1, 1, 1, 1, 2, 2, 2, 1, 1, 1, 1, 1, 1, 1, 1, 1, 1, 1, 1, 1, 1, 1, 1],
    [ 1, 1, 1, 1, 1, 1, 1, 1, 1, 1, 1, 1, 1,14, 1, 1, 1, 1, 1, 1, 1, 1, 1, 1, 1],
    [ 1,10,10, 1, 1, 1, 1, 1, 1, 1, 1, 1, 1, 1, 1, 1, 1, 1, 1, 1, 1, 1,10,10, 1],
    [ 1,10,12, 1, 1, 1, 1, 1, 1, 1, 1, 4, 4, 1, 1, 1, 1, 1, 1, 1, 1, 1,10,12, 1],
    [ 1, 1, 1, 1, 1, 1, 1, 1, 1, 1, 1, 1, 1, 1, 1, 2, 2, 3, 3, 2, 1, 1, 1, 1, 1],
    [ 1, 1, 1, 1, 1, 1, 1, 1, 1, 1, 1, 1, 1, 1, 2, 2, 3, 5, 3, 2, 2, 1, 1, 1, 1],
    [ 1, 1, 1, 1, 1, 1, 9, 9, 1, 1, 1, 1, 1, 1, 2, 3,15, 5,15, 3, 2, 1, 1, 1, 1],
    [ 1, 1, 1, 1, 1, 1, 9, 1, 1, 1, 1, 1, 1, 1, 2, 3, 6, 6, 6, 3, 2, 1, 1, 1, 1],
    [ 1, 1, 1, 1, 1, 1, 1, 1, 1, 1, 1, 1, 1, 1, 2, 3,17, 8,17, 3, 2, 1, 1, 1, 1],
    [ 1, 1, 1, 1, 1,16, 1, 1, 1, 1, 1, 1, 1, 1, 1, 2, 3, 3, 3, 2, 1, 1, 1, 1, 1],
    [ 1, 1, 1, 1, 1, 1, 1, 1, 1,13, 1, 1, 1, 1, 1, 1, 2, 2, 2, 1, 1, 1, 1, 1, 1],
    [ 1, 1, 4, 4, 1, 1, 1, 1, 1, 1, 1, 1, 1, 1, 1, 1, 1, 1, 1, 1, 1, 4, 4, 1, 1],
    [ 1, 1, 1, 4, 1, 1, 1, 1, 1, 1, 1, 1, 1, 1, 1, 1, 1, 1, 1, 1, 4, 4, 1, 1, 1]
  ],
  "units": [
    { "id": 1,  "player": 1, "type": "general",    "name": "ZAKU",    "col": 2,  "row": 2,  "mv": 4, "moved": false, "hp": 100 },
    { "id": 2,  "player": 1, "type": "general",    "name": "DOM",     "col": 3,  "row": 5,  "mv": 4, "moved": false, "hp": 100 },
    { "id": 3,  "player": 1, "type": "amphibious", "name": "ZGOK",    "col": 5,  "row": 8,  "mv": 4, "moved": false, "hp": 100 },
    { "id": 4,  "player": 1, "type": "ship",       "name": "MOUSAI",  "col": 1,  "row": 4,  "mv": 5, "moved": false, "hp": 100 },
    { "id": 5,  "player": 2, "type": "general",    "name": "GM",      "col": 22, "row": 2,  "mv": 4, "moved": false, "hp": 80  },
    { "id": 6,  "player": 2, "type": "general",    "name": "GUNDAM",  "col": 20, "row": 5,  "mv": 6, "moved": false, "hp": 100 },
    { "id": 7,  "player": 2, "type": "amphibious", "name": "AQUA-GM", "col": 18, "row": 8,  "mv": 4, "moved": false, "hp": 100 },
    { "id": 8,  "player": 2, "type": "ship",       "name": "SALAMIS", "col": 23, "row": 4,  "mv": 5, "moved": false, "hp": 100 }
  ],
  "players": {
    "1": { "ig": 550, "ct": 14300, "gp": 3, "gb": 2, "production": 0 },
    "2": { "ig": 1350, "ct": 2750, "gp": 3, "gb": 1, "production": 0 }
  }
}
